111111111
100N00001
10001E001
10C111111
100P0C001
111111111