111111111111111111111
100000E00000000000001
10000P011111111111111
100000C00000000000001
100001111000000000001
100001111000000N00001
100001111000000000001
111111111111111111111