11111111111111111111111111111111111111111111111111111111111111111111111111111111
1111111110000000000000001110000000000C000000000000000000000000000000000000000011
10000000000011111111111P000E0000000000000000000000000000000000000000000000000011
10000000000000000000000011110000000000000000000000000000000000000000000000000011
10000000000000000000000000000000000000000000000000000000000000000000000000000011
10000000000000000000000000000000000000000000000000000000000000000000000000000011
1000000000000C000000000000000000000000000000000000000000000000000000000000000011
1000C000000000000000000000000000000000000000000000000000000000000000000000000011
10000000000000000000000000000000000000000000000000000000000000000000000000000011
100000000000000000000000000000000000000000000000000001110C0111111111111111111111
10000000000000000000000000000000000000000000000000000000000000000000000000111111
10000000000000000000000000000000000000000000000000000000000000000000000000000011
10000000000000000000000000000000000000000000000000000000000000000000000000000011
1000000000000C000000000000000000000000000000000000000000000000000000000000000011
1000C000000000000000000000000000000000000000000000000000000000000000000000000011
10000000000000000000000000000000000000000000000000000000000000000000000000000011
100000000000000000000000000000000000000000011111111111100C0111111111111111111111
10000000000000000000000000000000000000000000000000000001100111111111111111111111
10000000000C00000000000000000000000000000000000000000000000111111111111111111111
10000000000000000000000000000000000000000000000000000000000000000111110000000011
10000000000000000000000000000000000000000000000000000000000000000000000000000111
10000000000000000000000000000000000000000000000000000000000000000000000000000011
11111111111111111111000000000000000000000000000000000000000000000000000000000011
11111111111111111111000000000000000000000000000000000000000000000000000000000011
11111111111111111111000000000000000000000000000000000000000000000000000000000011
10000000000000000000000000000000000000000000000000000000000000000000000000000011
1000000000000000000000000000000000000000000000000000000N000000000000000000000011
10000000000000000000000000000000000000000000000000000000000000000111110000000011
100000000000000000000000000000000000000000000000000000000C0111111111111111111111
10000000000000000000000000000000000000000000000000000000001111111111111111111111
10000000000C00000000000000000000000000000000000000000000000111111111111111111111
10000000000000000000000000000000000000000000000000000000000111111111111111111111
10000000000000000000000000000000000000000000000000000000000111111111111111111111
10000000000C00000000000000000000000000000000000011111100000111111111111111111111
10000000000000000000000000000000000000000000000000000000000000000000000000000011
10000000000000000000000000000000000000000000000000000000000000011111110000000011
10000000000000000000000000000000000000000000000000000000000000000000000000000011
11111111111111111111000000000000000000000000000000000000000000000000000000000011
11111111111111111111000000000000000000000000000000000000000000000000000000000011
11111111111111111111000000000000000000000000000000000000000000000000111100000011
10000000000000000000000000000000000000000000000000000000000000000011110000000011
10000000000000000000000000000000000000000000000000000000000000000000111110000011
11111111111111111111111111111111111111111111111111111111111111111111111111111111